3 1 3 1 3 1 3 1 3 1 3 1 3 1 3 1 3 1 3 1 3 1 3 1 
3 1 2 0 2 0 2 0 2 0 2 0 3 1 6 1 9 1 2 0 16 0 3 1 
3 1 2 0 3 1 6 1 3 1 2 0 2 0 2 0 2 0 2 0 4 1 3 1 
3 1 2 0 2 0 2 0 2 0 2 0 3 1 10 1 3 1 2 0 2 0 3 1 
3 1 3 1 3 1 3 1 2 0 3 1 5 1 3 1 2 0 2 0 2 0 3 1 
3 1 2 0 2 0 2 0 2 0 3 1 2 0 3 1 2 0 4 1 2 0 3 1	
3 1 3 1 2 0 3 1 2 0 3 1 2 0 3 1 2 0 3 1 2 0 3 1	
3 1 3 1 2 0 3 1 2 0 15 1 2 0 3 1 2 0 16 0 2 0 3 1 
3 1 16 0 2 0 2 0 2 0 3 1 2 0 2 0 2 0 3 1 2 0 3 1 
3 1 4 1 2 0 5 1 2 0 2 0 2 0 3 1 2 0 2 0 2 0 3 1 
3 1 3 1 3 1 3 1 3 1 3 1 3 1 3 1 3 1 3 1 3 1 3 1 