3 1 3 1 3 1 3 1 3 1 3 1 3 1 3 1 3 1 3 1 3 1 3 1 3 1 3 1 3 1 3 1 3 1 
3 1 2 0 2 0 2 0 2 0 2 0 3 1 7 1 9 1 2 0 2 0 2 0 2 0 2 0 2 0 7 1 3 1 
3 1 2 0 3 1 7 1 3 1 2 0 2 0 2 0 2 0 2 0 4 1 3 1 2 0 3 1 2 0 2 0 3 1 
3 1 2 0 2 0 2 0 2 0 2 0 3 1 10 1 3 1 2 0 2 0 3 1 2 0 3 1 3 1 2 0 3 1 
3 1 3 1 3 1 3 1 2 0 3 1 5 1 3 1 2 0 2 0 2 0 3 1 3 1 3 1 3 1 2 0 3 1 
3 1 2 0 2 0 2 0 2 0 3 1 2 0 3 1 2 0 4 1 2 0 1 0 2 0 2 0 2 0 2 0 3 1 
3 1 3 1 2 0 3 1 2 0 3 1 2 0 3 1 2 0 3 1 2 0 2 0 3 1 3 1 7 1 2 0 3 1 
3 1 3 1 2 0 3 1 2 0 15 1 2 0 3 1 2 0 2 0 2 0 3 1 3 1 5 1 3 1 2 0 3 1 
3 1 2 0 2 0 2 0 2 0 3 1 2 0 2 0 2 0 3 1 2 0 3 1 2 0 2 0 2 0 2 0 3 1 
3 1 2 0 3 1 2 0 3 1 3 1 3 1 3 1 2 0 2 0 2 0 3 1 2 0 3 1 3 1 2 0 3 1 
3 1 2 0 5 1 2 0 3 1 16 1 3 1 3 1 2 0 2 0 2 0 3 1 2 0 3 1 3 1 2 0 3 1 
3 1 2 0 3 1 2 0 3 1 3 1 3 1 3 1 2 0 2 0 2 0 3 1 2 0 2 0 2 0 2 0 3 1 
3 1 2 0 7 1 2 0 10 1 2 0 2 0 3 1 2 0 2 0 2 0 3 1 2 0 3 1 3 1 9 1 3 1 
3 1 4 1 2 0 2 0 2 0 2 0 2 0 3 1 2 0 4 1 2 0 3 1 2 0 2 0 2 0 2 0 3 1 
3 1 2 0 3 1 5 1 2 0 4 1 2 0 3 1 2 0 4 1 2 0 3 1 2 0 3 1 3 1 3 1 3 1 
3 1 2 0 2 0 2 0 2 0 2 0 2 0 3 1 2 0 4 1 2 0 3 1 15 1 3 1 3 1 3 1 3 1 
3 1 3 1 3 1 3 1 3 1 3 1 3 1 3 1 3 1 3 1 3 1 3 1 3 1 3 1 3 1 3 1 3 1 